{
    "0": "A010",
    "1": "A011",
    "2": "A016",
    "3": "A018",
    "4": "A023",
    "5": "A031",
    "6": "A035",
    "7": "A041",
    "8": "A053",
    "9": "A054"
}